10 7

0 0 0 0 0 0 0 0 0 0
0 1 1 9 1 1 2 1 1 0
0 1 2 2 2 1 2 1 1 0
0 2 2 2 1 1 2 2 1 0
0 1 1 1 1 2 2 1 1 8
8 1 1 1 1 1 1 1 1 0
0 0 0 0 0 0 0 8 0 0